1111111111
1P000000C1
1000110001
1C10CC01C1
1000110001
1C10CC01C111
1000110001001
1C10CC01C11
1000110001
1C000000E1
1111011111
