111111111111111111111
100CCC0000P0000CCC001
100111000111000111001
100CCC0x0CCC0x0CCC001
101101000111000101101
101101000CCC000101101
10CCC0x0111110x0CCC01
101110100CCC001011101
10CCC01000E00010C1C01
111111111111111111111
