1111111111
1P000000C1
1000110001
1C10CC01C1
1000110001
1C10CC01C1
1000110001
1C10CC01C1
1000110001
1E000000E1
1111111111
