1111111111
1P000x00C1
1000110001
1C10CC01C1
1000110001
1C10CC01C1
10x0110x01
1C10CC01C1
1x001100x1
1E000x00E1
1111111111
