1111111111
1P000x0001
1000110001
1010000101
1000110001
1010000101
10x0110x01
1010000101
1x001100x1
10000x00E1
1111111111
