1111111111
1001000101
1111111111
